NCNS (Qualified Athletes Only)	North Dakota	November 16 - 17th
Hit Squad Ninjas	Arizona	March 22nd
605 Ninja	South Dakota	March 22nd
Move Sport Ninja Academy	Texas	March 29th
Ninja Obstacle Academy	Alabama	April 5th
Authentik Movement Training	Ohio	April 5th
Leap Ninja	Wyoming	April 5 - 6th
The Ninja Playground	Utah	April 11 - 12th
NinjaKour	Georgia	April 12th
Conquer Gym - Fargo	North Dakota	April 12 - 13th
Tri County	Michigan	April 13th
Vertex Lab Academy	Virginia	April 19th
The Grip	Utah	April 25 - 26th
Next Level	Oklahoma	April 26th
Conquer Gym - Blaine	Minnesota	April 26 - 27th
The Wolfs Den	California	April 26th
Republic Warrior Sports	Missouri	May 3rd
Ninjobstacles	Ohio	May 3rd - 4th
Republic Warrior Sports	Missouri	May 3rd
Ninjobstacles	Ohio	May 3rd - 4th
Rock Solid Warrior - Fuquay	North Carolina	May 3rd - 4th
Surge Ninja	Massachusetts	May 3rd - 4th
Altitude Movement Gym	Colorado	May 4th
Bodies In Motion	Idaho	May 10th
Magic City Gymnastics	Montana	May 10th
Free Spirit	Oregon	May 11th
Permian Basin Ninja Academy	Texas	May 17th
Ultimate Ninjas - Anaheim	California	May 17th
Ninja Lair	Nevada	May 17 - 18th
Iron Sports Ninja Warrior	Texas	May 24 - 25th
Ninjas United	Minnesota	May 24-25th
Warrior Playground	Colorado	May 31st
ORTHDX	Wisconsin	May 31st
Power Pickle	Texas	June 6th - 7th
Fortified Fitness	Tennessee	June 7th
Paragon Performance Sports	Kansas	June 7th
305 Ninja Academy	Florida	June 7th
Ninja Fortress	Washington	June 7th
USA Ninja Challenge - Marlborough	Massachusetts	June 7 - 8th
Kid Wonder	California	June 7 - 8th
Ultimate Ninjas - Elmhurst	Illinois	June 8th
Ninja Force	New Mexico	June 8th